-------------------- 
|^^############^^^^|
|^^^############^^^|
|^^^^^#########^^^^|
|^^^^^##^^^^^##^^^^|
|^^^^###^^^^^##^^^^|
|^^^^###^^^^^###^^^|
|^^^^###^^^^^^##^^^|
|########^^^^######|
|#######^^^^^######|
|-----###^^^^######|
|#########^^^######|
|#####|###^^^######|
|#####|###^^#######|
|-----#####^#######|
|#####|############|
|#####|############|
|#####|############|
|##################|
--------------------